mild_climate_large_mine =
{
	mine_RGO_eff = 1
}

mild_climate =
{
	farm_rgo_size = 0.0
	farm_rgo_eff = 0.0
	mine_rgo_size = 0.0
	mine_rgo_eff = 0.0
}

temperate_climate_large_mine =
{
	mine_RGO_eff = 1
}

temperate_climate =
{
	farm_rgo_size = 0.0
	farm_rgo_eff = 0.0
	mine_rgo_size = 0.0
	mine_rgo_eff = 0.0
}

harsh_climate_large_mine =
{
	mine_RGO_eff = 1
	
}

harsh_climate =
{
	farm_rgo_size = 0.0
	farm_rgo_eff = 0.0
	mine_rgo_size = 0.0
	mine_rgo_eff = 0.0
	
}

inhospitable_climate_large_mine =
{
	mine_RGO_eff = 1
	
}

inhospitable_climate =
{
	farm_rgo_size = 0.0
	farm_rgo_eff = 0.0
	mine_rgo_size = 0.0
	mine_rgo_eff = 0.0
	
}

mild_climate_large_mine = {
	2264 2270 2305 2309
}

mild_climate = {
	84 85 86 87 88 89 90 139 140 141 191 192 193 194 195 196 197 198 199 200 204 205 206 207 208 209 210 211 212 213 214
	334 335 366 372 373 377 382 384 442 443 444 445 446 447 450 451 453 454 456 458 459 461 462 463 467 468 469 470 471
	472 473 491 498 501 502 503 504 505 506 507 508 509 510 511 512 513 514 515 516 517 530 531 532 544 545 546 547 600 
	601 602 603 604 605 631 632 633 634 635 636 639 640 641 642 643 644 646 647 648 649 650 651 652 653 654 655 656 724 
	725 731 733 736 738 739 740 749 750 754 755 756 758 760 780 781 782 800 801 814 817 818 819 821 822 823 824 825
	826 827 828 829 830 832 834 835 836 837 838 839 840 841 842 843 844 845 846 850 851 854 856 858 859 860 861 869 872
	875 894 895 900 905 926 927 930 932 944 958 961 962 963 964 965 966 968 969 970 973 974 975 976 977 978 979 980 1036
	1047 1048 1049 1097 1136 1138 1141 1142 1251 1261 1262 1266 1267 1268 1269 1276 1277 1278 1285 1286 1288 1291 1292
	1293 1296 1297 1299 1300 1301 1303 1305 1306 1307 1309 1310 1312 1324 1343 1344 1345 1346 1351 1352 1353 1354 1365 1366
	1367 1370 1373 1379 1380 1381 1382 1383 1393 1394 1411 1412 1413 1415 1417 1421 1423 1424 1431 1433 1438 1439 1440 1441
	1442 1443 1444 1445 1446 1447 1448 1452 1455 1456 1457 1458 1459 1460 1461 1462 1464 1493 1496 1501 1536 1537 1538
	1539 1540 1541 1544 1565 1566 1567 1569 1571 1606 1608 1609 1610 1611 1626 1628 1632 1633 1634 1635 1636 1637 1640
	1641 1646 1647 1648 1649 1650 1651 1655 1656 1658 1678 1679 1723 1725 1726 1728 1730 1731 1733 1734 1735 1736 1737
	1745 1746 1747 1748 1749 1750 1751 1752 1753 1763 1764 1887 1888 1892 1893 1894 1908 1909 1911 1912 1914 1919 1923
	1928 1934 1935 1943 1951 1968 2003 2004 2015 2019 2020 2021 2022 2023 2029 2030 2033 2036 2037 2038 2039 2048 2095
	2096 2098 2100 2111 2113 2118 2119 2120 2121 2122 2123 2124 2125 2126 2127 2128 2129 2130 2134 2135 2136 2137 2138
	2139 2140 2141 2149 2150 2156 2157 2162 2163 2164 2165 2168 2169 2171 2178 2179 2182 2186 2189 2190 2191 2192 2193
	2195 2196 2198 2201 2202 2203 2204 2205 2208 2209 2210 2211 2213 2214 2215 2217 2218 2219 2220 2222 2223 2224 2225
	2226 2227 2228 2229 2230 2231 2232 2234 2235 2236 2237 2238 2239 2240 2241 2253 2255 2258 2265 2266 2267 2274 2276 2280 2281 2291 2304 2312 2314 2323 2325 2326 2344 2345 2347 2349 2350 2351 2352 2353 2356 2358
	2359 2360 2364 2365 2366 2367 2376 2377 2380 2381 2382 2383 2409 2410 2411 2412 2414 2415 2424 2428 2429 2431 2432
	2434 2435 2436 2439 2446 2447 2448 2449 2451 2455 2457 2461 2468 2469 2470 2471 2472 2476 2477 2478 2479 2482 2483
	2484 2485 2486 2487 2488 2491 2492 2493 2494 2495 2496 2497 2498 2499 2501 2502 2504 2505 2506 2509 2510 2512 2515
	2557 2573 2578 2582 2602 2161 2233 2243 2244 2562 2565 2567 2660 2724 2751 2761
	
	
	
}


temperate_climate_large_mine = {
	132 177 763 764
}

temperate_climate = {
	46 47 48 49 50 51 52 53 54 55 56 57 58 60 64 65 81 82 83 100 101 102 103 104 105 106 107 108 109 110 111 112 115 116 
	117 118 119 120 121 122 123 124 125 126 127 128 129 130 131 133 134 135 136 137 138 142 143 144 145 146 147 148 149 
	150 151 152 153 154 172 173 174 175 176 178 179 180 181 182 183 184 185 186 187 188 189 190 201 202 203 215 217 219 
	220 221 222 223 224 225 226 227 228 229 230 231 232 233 234 235 236 237 238 239 240 241 242 243 244 245 254 255 256 
	257 258 259 260 261 262 263 264 265 272 273 274 275 276 277 278 279 280 281 282 283 284 285 286 287 288 289 290 291 
	292 293 294 295 296 297 298 299 300 301 302 303 304 308 309 310 311 312 313 316 317 322 323 324 325 326 327 328 329 
	330 331 332 333 340 341 343 344 345 346 347 348 349 350 351 352 353 354 355 356 357 358 359 360 361 362 363 364 365 
	367 368 369 370 371 374 375 376 378 379 380 381 383 385 386 387 388 389 390 391 392 393 394 395 396 397 398 399 400 
	401 402 403 404 405 406 407 408 409 410 411 412 413 414 415 416 417 418 419 420 421 422 423 424 425 426 427 428 429 
	430 431 432 433 434 435 436 437 438 439 440 441 448 449 452 455 474 475 476 477 478 479 480 481 482 483 484 485 486 
	487 488 489 490 492 494 495 497 518 519 520 521 522 523 524 525 526 527 528 529 534 535 536 537 538 539 540 541 542 
	543 548 549 550 551 552 553 554 555 556 557 558 559 560 561 562 563 564 565 566 567 568 569 570 571 572 573 574 575 
	576 577 578 579 580 581 582 583 584 585 586 587 588 589 590 591 593 594 595 596 597 598 611 616 617 618 619 620 621 
	622 623 624 625 626 627 628 629 630 645 657 658 659 660 661 662 663 664 665 666 667 668 669 670 671 672 673 674 675 
	676 677 678 679 680 681 682 683 684 685 686 687 688 689 690 691 692 693 694 695 696 697 698 699 700 701 702 703 704 
	705 706 707 708 709 710 720 721 722 723 726 727 728 729 730 732 741 742 743 744 745 746 747 748 751 752 753 757 759 
	761 762 765 766 767 768 769 770 771 772 773 774 775 776 777 778 779 791 792 793 794 795 796 797 798 799 802 803 804 
	805 806 807 808 809 810 811 812 831 849 852 857 867 868 870 871 878 880 882 892 893 901 915 916 929 933 936 937 954 
	955 956 957 960 967 971 972 994 999 1019 1021 1033 1034 1037 1038 1039 1040 1041 1043 1044 1045 1050 1051 1057 1094 
	1096 1110 1111 1117 1118 1119 1120 1121 1122 1123 1126 1131 1132 1133 1134 1135 1145 1191 1192 1198 1227 1234 1236 
	1237 1239 1240 1241 1242 1243 1244 1245 1246 1247 1248 1249 1250 1253 1254 1255 1256 1281 1282 1283 1294 1295 1302 
	1308 1311 1319 1321 1322 1330 1331 1332 1334 1335 1362 1363 1364 1369 1374 1375 1376 1377 1384 1385 1386 1387 1388 
	1389 1395 1396 1398 1402 1403 1404 1405 1406 1414 1416 1418 1419 1420 1430 1432 1435 1437 1449 1450 1451 1463 1470 
	1471 1472 1473 1474 1475 1476 1477 1478 1479 1480 1481 1482 1483 1484 1485 1486 1487 1488 1489 1490 1494 1495 1497 
	1498 1499 1500 1502 1503 1504 1505 1506 1507 1508 1509 1510 1511 1512 1514 1515 1516 1517 1518 1519 1520 1521 1522 
	1523 1524 1525 1542 1543 1545 1547 1548 1549 1550 1551 1559 1563 1564 1568 1570 1574 1575 1576 1577 1578 1579 1583 
	1601 1602 1604 1605 1607 1612 1614 1615 1616 1617 1618 1619 1624 1625 1627 1629 1630 1631 1638 1652 1653 1661 1662 
	1663 1664 1667 1668 1669 1670 1671 1672 1700 1701 1704 1705 1706 1709 1783 1784 1785 1849 1851 1852 1853 1854 1855 
	1856 1857 1858 1868 1869 1870 1876 1877 1879 1884 1889 1890 1891 1895 1896 1897 1898 1899 1920 1921 1922 1924 1925 
	1928 1931 1932 1933 1945 1946 1947 1948 1949 1952 1953 1954 1955 1956 1957 1958 1966 1969 1972 1973 1974 2001 2005 
	2016 2017 2031 2032 2034 2050 2051 2059 2060 2061 2062 2063 2064 2065 2066 2067 2087 2091 2093 2094 2103 2104 2105 
	2106 2107 2108 2109 2110 2117 2142 2143 2144 2147 2148 2151 2152 2153 2159 2170 2172 2175 2180 2212 2221 2268 2269 
	2282 2285 2292 2295 2297 2298 2306 2316 2317 2318 2320 2330 2337 2338 2339 2340 2343 2360 2361 2362 2384 2386 2408 
	2419 2420 2426 2440 2441 2442 2445 2453 2454 2458 2460 2462 2465 2466 2467 2480 2481 2516 2517 2518 2519 2525 2538 
	2555 2558 2659 2561 2583 2584 2604 2570 2621 2673 2674 2684 2680 2693 2692 2701 2503
}

harsh_climate_large_mine = {
	158 306 2307 2308 2532
}

harsh_climate = {
	9 21 22 24 25 26 27 28 29 30 31 32 33 34 35 36 37 38 39 40 41 42 59 61 62 63 66 67 68 69 70 71 72 73 74 75 76 77 
	78	79 80 91 92 93 94 95 96 97 98 99 113 114 155 156 157 159 160 161 162 163 164 165 166 167 168 169 170 171 216 
	218 246 247 248 249 250 252 253 266 267 268 269 270 271 305 314 315 318 319 336 337 339 342 457 460 464 465 466 
	493 496 499 500 533 592 599 606 607 608 609 610 612 613 614 615 637 638 711 712 713 714 715 716 717 718 719 734 
	735 761 783 784 785 786 787 788 789 813 815 816 820 833 847 848 853 855 862 863 864 865 866 873 874 876 877 879 881 
	883 884 885 886 887 888 889 890 891 896 897 898 899 902 903 904 906 907 908 909 910 913 914 917 918 919 920 923 
	924 925 928 938 939 940 941 942 943 945 946 947 948 949 951 952 953 959 991 992 996 997 998 1000 1001 1002 1003 1004 1005 1006 1007 1008 1009 1010 1011 1012 1013 1014 1015 1016 1017 1018 1020 1022 1023 1024 1025 1026 1027 1028 1029 1030 1031 1032 1035 1042 1046 1052 1053 1054 1055 1056 1082 1083 1084 1085 1093 1095 1103 1109 1113 1114 1115 1124 1125 1127 1128 1129 1130 1137 1139 1162 1165 1166 1167 1168 1169 1170 1171 1177 1178 1179 1183 1194 1195 1196 1202 1206 1209 1211 1214 1215 1216 1221 1233 1229 1231 1235 1257 1258 1263 1264 1265 1270 1272 1274 1275 1279 1280 1284 1287 1304 1313 1314 1315 1316 1317 1318 1320 1325 1333 1336 1337 1347 1348 1349 1350 1358 1359 1368 1371 1372 1378 1390 1391 1392 1397 1399 1400 1401 1407 1408 1409 1410 1422 1426 1427 1428 1429 1434 1436 1453 1454 1491 1492 1513 1526 1527 1528 1529 1530 1531 1532 1533 1534 1546 1554 1555 1560 1561 1562 1572 1573 1580 1584 1587 1603 1613 1620 1621 1639 1642 1643 1645	1654 1657 1659 1660 1665 1666 1673 1674 1675 1676 1677 1685 1686 1687 1688 1689 1690 1691 1693 1694 1695 1696 1702 1703 1707 1708 1727 1729 1732 1738 1740 1741 1754 1755 1765 1767 1769 1770 1771 1772 1775 1776 1777 1778 1779 1786 1787 1788 1789 1792 1818 1819 1820 1850 1859 1860 1861 1871 1872 1873 1874 1875 1878 1880 1881 1882 1885 1886 1900 1901 1910 1913 1915 1916 1917 1918 1926 1927 1929 1930 1936 1937 1938 1939 1940 1941 1943 1959 1970 1971 1975 1976 1977 1978 1979 1985 1986 1988 1989 1998 1999 2000 2002 2006 2018 2035 2041 2044 2045 2052 2053 2068 2069 2070 2071 2072	2073 2088 2089 2090 2092 2097 2099 2101 2102 2112 2114 2115 2116 2131 2132 2133 2145 2146 2158 2160 2166 2167 2174 2176 2177 2181 2182 2183 2184 2185 2187 2188 2194 2197 2199 2200 2206 2216 2242 2245 2246 2247 2254 2256 2257 2259 2260 2261 2262 2263 2271 2272 2273 2275 2277 2279 2296 2299 2300 2301 2302 2303 2319 2321 2322 2336 2341 2342 2346 2348 2354 2355 2357 2363 2378 2379 2395 2396 2406 2413 2416 2421 2422 2423 2425 2427 2430 2433 2437 2438 2443 2444 2450 2452 2456 2459 2463 2464 2500 2508 2511 2513 2514 2521 2526 2527 2528 2529 2530 2531 2533 2534 2537 2539 2540 2541 2542 2543 2544 2545 2546 2547 2548 2556 2571 2572 2574 2575 2576 2577 2579 2580 2581 2594 2610 2611 2612	2635 2173 2563 2566 2568 2569 2687
	
	
}

inhospitable_climate_large_mine = {
	320 321 2619
}
inhospitable_climate = {
	1 2 3 4 5 6 7 8 10 11 12 13 14 15 16 17 18 19 20 23 43 44 45 251 307 338 737 790 911 912 921 922 931 934 935 950 981 982 
	983 984 985 986 987 988 989 990 993 995 1058 1059 1060 1061 1062 1063 1064 1065 1066 1067 1068 1069 1070 1071 1072 1073 
	1074 1075 1076 1077 1078 1079 1080 1081 1086 1087 1088 1089 1090 1091 1092 1098 1099 1100 1101 1102 1104 1105 1106 1107 
	1108 1112 1116 1140 1143 1144 1146 1147 1148 1149 1150 1151 1152 1153 1154 1155 1156 1157 1158 1159 1160 1161 1163 1164 
	1172 1173 1174 1175 1176 1180 1181 1182 1184 1185 1186 1187 1188 1189 1190 1193 1197 1199 1200 1201 1203 1204 1205 1207 
	1208 1210 1212 1213 1217 1218 1219 1220 1222 1223 1224 1225 1226 1228 1230 1232 1238 1252 1259 1260 1271 1273 1289 1290 
	1298 1323 1326 1327 1328 1329 1338 1339 1340 1341 1342 1355 1356 1357 1360 1361 1425 1465 1466 1467 1468 1469 1535 1552 
	1553 1556 1557 1558 1581 1582 1585 1586 1588 1589 1590 1591 1592 1593 1594 1595 1596 1597 1598 1599 1600 1622 1623 1644 
	1680 1681 1682 1683 1684 1692 1697 1698 1699 1710 1711 1712 1713 1714 1715 1716 1717 1718 1719 1720 1721 1722 1724 1739 
	1742 1743 1744 1756 1757 1758 1759 1760 1761 1762 1766 1768 1773 1774 1780 1781 1782 1790 1791 1793 1794 1795 1796 1797 
	1798 1799 1800 	1801 1802 1803 1804 1805 1806 1807 1808 1809 1810 1811 1812 1813 1814 1815 1816 1817 1821 1822 1823 1824 
	1825 1826 1827 1828 1829 1830 1831 1832 1833 1834 1835 1836 1837 1838 1839 1840 1841 1842 1843 1844 1845 1846 1847 1848 
	1862 1863 1864 1865 1866 1867 1883 1902 1903 1904 1905 1906 1907 1942 1944 1950 1960 1961 1962 1963 1964 1965 1967 1980 
	1981 1982 1983 1984 1987 1990 1991 1992 1993 1994 1995 1996 1997 2007 2008 2009 2010 2011 2012 2013 2014 2024 2025 2026 
	2027 2028 2040 2042 2043 2046 2047 2049 2054 2055 2056 2057 2058 2074 2075 2076 2077 2078 2079 2080 2081 2082 2083 2084 
	2085 2086 2154 2155 2207 2248 2249 2250 2251 2252 2278 2283 2284 2286 2287 2288 2289 2290 2293 2294 2310 2311 2313 2315 
	2324 2327 2328 2329 2331 2332 2333 2334 2335 2368 2369 2370 2371 2372 2373 2374 2375 2385 2387 2388 2389 2390 2391 2392 
	2393 2394 2397 2398 2399 2400 2401 2402 2403 2404 2405 2407 2417 2418 2473 2474 2475 2489 2490 2495 2507 2519 2520 2522 
	2523 2524 2535 2536 2549 2550 2551 2552 2553 2554 2559 2560 2564 2585 2586 2587 2588 2589 2590 2591 2592 2593 2595 2596 
	2597 2598 2599 2600 2601 2603 2605 2606 2607 2608 2609 2613 2614 2615 2616 2617 2618 2620 2622 2623 2624 2625 2626 2627 
	2628 2629 2630 2631 2632 2633 2634 2636 2637 2638 2639 2640 2641 2642 2643 2644 2645 2646 2647 2648 2649 2650 2651 2652 
	2653 2654 2655 2656 2657 2658 2661 2662 2663 2664 2665 2666 2667 2668 2669 2670 2671 2672 2675 2676 2677 2678 2679 2681 
	2682 2683 2685 2686 2688 2689 2690 2691 2694 2695 2696 2697 2698 2699 2700 2702 3246
}